NO ./textures/wall_n.xpm
SO ./textures/wall_s.xpm
WE ./textures/wall_w.xpm
EA ./textures/wall_e.xpm

F 71,79,73
C 0,0,0

        1111111111111111111111111
        1000000000110000000000001
        1011000001110000000000001
        10010000000000000000000S1
111111111011000001010000000000001
100000000011000001010111111111111
11110111111111011100100010001
11110111111111011101010010001
11000000110101011100000010001
10000000000000001100000010001
10000000000000001101010010001
1100000111010101111101111000111
11110111 1110101 101111010001
11111111 1111111 1111  1111111