NO ./textures/wall_n.xpm
SO ./textures/wall_s.xpm
WE ./textures/wall_w.xpm
EA ./textures/wall_e.xpm

F 71,79,73
C 0,0,0
                                1111111111111111111111111111111
11111111111111111111111111111111100000000000000001000000000000111111111111111111
100000000000000000000000000000000000000000000000001111000000000000000000000000001
101111111111111111111111111111111000000000000000000000000000001111111111111111101
101                             1000000011100011101111111111111111111111111111101
101                             1111111111110011111111111111111111111111111111101
101                                        1001                               101
101                                        1001                               101
1011111111                      111111111111001111111111111111                101
1111111111         111111111111110000000000000000000000000000111111111111111111011111111111111111111111111111                             111111111111111111111111111111111111111
10000000011111111111000000000000000000000000000000000000000000000000000000000000000000000000000111111                                     1000000000000000000000000000000000000001
10E0000000000000000000000000000000000000000000000000000000000000000000000000000111111111111111000001111111                                10000000000000000000000000000000000000001
10000000011111111111000000000100000000010000000000000000000000111111111111111011             100000000001111111111111111111111111111111111100000000000000000000000000000000000000001
100111111        111110000000010000000000000000000000000000000111111111111111011             10000000000000000000000000000000000000000000000000000000000000000000000000000000000111
101          111110000000000000000000000000000000000000000000011111111111111101              100000000000000011111111111111111111111111111100000000000000000000000000000000000000001
10011111          11111000000000000000000000000111111111111111              10111111111111111101111111111111111111                         1000000000000000000000011111111111111111111
10011111          111110000000000000000000000000000000000000001             100000000000000000011111                                        1110000000000000000000000000000000000000001
100000001          11111000000000000000000000000000000000000001             1011111111111111111111111                                        111000000000000000000000000000000000000001
100000001          111000000000000000000000000000000000000000111111111111111101111                                                          100000000000000000000000000000011111111111111111
100000001          111000000000111111111111100000000000000000000000000000000001111                                                           111111111111100000000000000000000000000000000001
100000001          1111111000000000000000000000000000000000000000111111111011111111111                                                       1000000000000000000000000000000000011111111111111
1000000011111          1111110000000000000000000000000000000000000001    101                                                                1000000000000000000000000000000000011
1000000000011          111100000000000000000000000000000000000000011     101111111111                                                        1111111111111111111111111111111111111
10000000001          1111110000000000000000000000000000000000000001      1000000000011
1001111111               11111111111111111110011111111111111111111       111111111101
1000000011          111110000000000000000000000000000000000000001111111           101
100000001          11110000000000000000000000000000000000000001111111             101
100000001111111        11111000000000000000000000000000000000000000111111111111111101
1000000000000001111111    11110000000000000000000000000000000000000000000000000000001111
11111111100000000111111     1111111111111111111101111111111111110111111111111111111111111
10000000000000001                             11011            101
111111000000000011111111111111111111111111111111011111111111111101
10000000000000000000000000000000000000000000000000000000000000000111111111111
11111111111111111111101111111111111111111111111011111111111111111111111111111
                    101                       101
                    101                       101
                    101            11111111111101111111111111
                    101            11111111100000001111111111
                    101            11000000000000000000000001
                    101            11111111111000000000000001
                    10111111111111111000000000000000000000001
                    10000000000000000011000000000001111111111
                    11111111111111111000000000000000000000001
                                    11111111111111111111111111